"filename", "language", "JavaScript", "CSS", "HTML", "Markdown", "JSON", "comment", "blank", "total"
"c:\Users\Artem\Documents\Project\LearnIT\README.md", "Markdown", 0, 0, 0, 2, 0, 0, 1, 3
"c:\Users\Artem\Documents\Project\LearnIT\build\asset-manifest.json", "JSON", 0, 0, 0, 0, 15, 0, 0, 15
"c:\Users\Artem\Documents\Project\LearnIT\build\home.html", "HTML", 0, 0, 38, 0, 0, 0, 0, 38
"c:\Users\Artem\Documents\Project\LearnIT\build\index.html", "HTML", 0, 0, 1, 0, 0, 0, 0, 1
"c:\Users\Artem\Documents\Project\LearnIT\build\precache-manifest.235954b715b509aee62df9cc55aa4c45.js", "JavaScript", 26, 0, 0, 0, 0, 0, 0, 26
"c:\Users\Artem\Documents\Project\LearnIT\build\service-worker.js", "JavaScript", 11, 0, 0, 0, 0, 17, 7, 35
"c:\Users\Artem\Documents\Project\LearnIT\build\static\css\2.90456dce.chunk.css", "CSS", 0, 1, 0, 0, 0, 1, 0, 2
"c:\Users\Artem\Documents\Project\LearnIT\build\static\css\main.e193d6e2.chunk.css", "CSS", 0, 1, 0, 0, 0, 1, 0, 2
"c:\Users\Artem\Documents\Project\LearnIT\build\static\js\2.339374bd.chunk.js", "JavaScript", 1, 0, 0, 0, 0, 1, 0, 2
"c:\Users\Artem\Documents\Project\LearnIT\build\static\js\main.aff91d78.chunk.js", "JavaScript", 1, 0, 0, 0, 0, 1, 0, 2
"c:\Users\Artem\Documents\Project\LearnIT\build\static\js\runtime~main.a8a9905a.js", "JavaScript", 1, 0, 0, 0, 0, 1, 0, 2
"c:\Users\Artem\Documents\Project\LearnIT\package-lock.json", "JSON", 0, 0, 0, 0, 18670, 0, 1, 18671
"c:\Users\Artem\Documents\Project\LearnIT\package.json", "JSON", 0, 0, 0, 0, 41, 0, 1, 42
"c:\Users\Artem\Documents\Project\LearnIT\public\home.html", "HTML", 0, 0, 38, 0, 0, 0, 0, 38
"c:\Users\Artem\Documents\Project\LearnIT\public\index.html", "HTML", 0, 0, 18, 0, 0, 0, 0, 18
"c:\Users\Artem\Documents\Project\LearnIT\src\App.js", "JavaScript", 51, 0, 0, 0, 0, 0, 11, 62
"c:\Users\Artem\Documents\Project\LearnIT\src\AppWithoutEpic.js", "JavaScript", 102, 0, 0, 0, 0, 0, 24, 126
"c:\Users\Artem\Documents\Project\LearnIT\src\css\components.css", "CSS", 0, 3, 0, 0, 0, 0, 0, 3
"c:\Users\Artem\Documents\Project\LearnIT\src\css\main.css", "CSS", 0, 327, 0, 0, 0, 0, 61, 388
"c:\Users\Artem\Documents\Project\LearnIT\src\index.js", "JavaScript", 11, 0, 0, 0, 0, 0, 4, 15
"c:\Users\Artem\Documents\Project\LearnIT\src\js\components\GroupCell.js", "JavaScript", 17, 0, 0, 0, 0, 0, 7, 24
"c:\Users\Artem\Documents\Project\LearnIT\src\js\components\Question.js", "JavaScript", 50, 0, 0, 0, 0, 0, 12, 62
"c:\Users\Artem\Documents\Project\LearnIT\src\js\components\modals\HomeBotInfoModal.js", "JavaScript", 52, 0, 0, 0, 0, 0, 8, 60
"c:\Users\Artem\Documents\Project\LearnIT\src\js\components\modals\HomeBotsListModal.js", "JavaScript", 64, 0, 0, 0, 0, 0, 11, 75
"c:\Users\Artem\Documents\Project\LearnIT\src\js\panels\home\groups.js", "JavaScript", 119, 0, 0, 0, 0, 0, 24, 143
"c:\Users\Artem\Documents\Project\LearnIT\src\js\panels\home\home.js", "JavaScript", 33, 0, 0, 0, 0, 3, 4, 40
"c:\Users\Artem\Documents\Project\LearnIT\src\js\panels\home\test.js", "JavaScript", 210, 0, 0, 0, 0, 1, 31, 242
"c:\Users\Artem\Documents\Project\LearnIT\src\js\panels\more\base.js", "JavaScript", 93, 0, 0, 0, 0, 0, 17, 110
"c:\Users\Artem\Documents\Project\LearnIT\src\js\panels\more\example.js", "JavaScript", 102, 0, 0, 0, 0, 0, 18, 120
"c:\Users\Artem\Documents\Project\LearnIT\src\js\services\ApiController.js", "JavaScript", 7, 0, 0, 0, 0, 0, 2, 9
"c:\Users\Artem\Documents\Project\LearnIT\src\js\services\VK.js", "JavaScript", 7, 0, 0, 0, 0, 2, 3, 12
"c:\Users\Artem\Documents\Project\LearnIT\src\js\services\_functions.js", "JavaScript", 31, 0, 0, 0, 0, 0, 12, 43
"c:\Users\Artem\Documents\Project\LearnIT\src\js\services\renderers.js", "JavaScript", 15, 0, 0, 0, 0, 0, 1, 16
"c:\Users\Artem\Documents\Project\LearnIT\src\js\store\formData\actionTypes.js", "JavaScript", 1, 0, 0, 0, 0, 0, 0, 1
"c:\Users\Artem\Documents\Project\LearnIT\src\js\store\formData\actions.js", "JavaScript", 10, 0, 0, 0, 0, 0, 1, 11
"c:\Users\Artem\Documents\Project\LearnIT\src\js\store\formData\reducers.js", "JavaScript", 20, 0, 0, 0, 0, 0, 7, 27
"c:\Users\Artem\Documents\Project\LearnIT\src\js\store\reducers.js", "JavaScript", 9, 0, 0, 0, 0, 0, 1, 10
"c:\Users\Artem\Documents\Project\LearnIT\src\js\store\router\actionTypes.js", "JavaScript", 7, 0, 0, 0, 0, 0, 0, 7
"c:\Users\Artem\Documents\Project\LearnIT\src\js\store\router\actions.js", "JavaScript", 50, 0, 0, 0, 0, 0, 8, 58
"c:\Users\Artem\Documents\Project\LearnIT\src\js\store\router\reducers.js", "JavaScript", 250, 0, 0, 0, 0, 0, 60, 310
"c:\Users\Artem\Documents\Project\LearnIT\src\js\store\vk\actionTypes.js", "JavaScript", 5, 0, 0, 0, 0, 0, 0, 5
"c:\Users\Artem\Documents\Project\LearnIT\src\js\store\vk\actions.js", "JavaScript", 46, 0, 0, 0, 0, 0, 5, 51
"c:\Users\Artem\Documents\Project\LearnIT\src\js\store\vk\reducers.js", "JavaScript", 68, 0, 0, 0, 0, 0, 12, 80
"Total", "-", 1470, 332, 95, 2, 18726, 28, 354, 21007